"filename", "language", "C++", "JSON", "comment", "blank", "total"
"c:\Users\xiong\Desktop\Sorting_Visulization_cqz\.vs\ProjectSettings.json", "JSON", 0, 3, 0, 0, 3
"c:\Users\xiong\Desktop\Sorting_Visulization_cqz\.vs\VSWorkspaceState.json", "JSON", 0, 7, 0, 0, 7
"c:\Users\xiong\Desktop\Sorting_Visulization_cqz\bestsort.cpp", "C++", 97, 0, 1, 25, 123
"c:\Users\xiong\Desktop\Sorting_Visulization_cqz\bestsort.h", "C++", 18, 0, 1, 7, 26
"c:\Users\xiong\Desktop\Sorting_Visulization_cqz\bestsortwin.cpp", "C++", 168, 0, 3, 14, 185
"c:\Users\xiong\Desktop\Sorting_Visulization_cqz\bestsortwin.h", "C++", 38, 0, 0, 13, 51
"c:\Users\xiong\Desktop\Sorting_Visulization_cqz\esort.cpp", "C++", 158, 0, 5, 37, 200
"c:\Users\xiong\Desktop\Sorting_Visulization_cqz\esort.h", "C++", 14, 0, 0, 3, 17
"c:\Users\xiong\Desktop\Sorting_Visulization_cqz\main.cpp", "C++", 11, 0, 0, 4, 15
"c:\Users\xiong\Desktop\Sorting_Visulization_cqz\mainwindow.cpp", "C++", 633, 0, 91, 135, 859
"c:\Users\xiong\Desktop\Sorting_Visulization_cqz\mainwindow.h", "C++", 100, 0, 6, 13, 119
"c:\Users\xiong\Desktop\Sorting_Visulization_cqz\no10.cpp", "C++", 118, 0, 36, 27, 181
"c:\Users\xiong\Desktop\Sorting_Visulization_cqz\num7.cpp", "C++", 169, 0, 12, 42, 223
"c:\Users\xiong\Desktop\Sorting_Visulization_cqz\sortAlgorithms.cpp", "C++", 629, 0, 36, 122, 787
"c:\Users\xiong\Desktop\Sorting_Visulization_cqz\sortAlgorithms.h", "C++", 63, 0, 0, 10, 73
"c:\Users\xiong\Desktop\Sorting_Visulization_cqz\sortalgotime.cpp", "C++", 350, 0, 19, 79, 448
"c:\Users\xiong\Desktop\Sorting_Visulization_cqz\sortalgotime.h", "C++", 52, 0, 0, 10, 62
"c:\Users\xiong\Desktop\Sorting_Visulization_cqz\sortwindow.cpp", "C++", 152, 0, 10, 15, 177
"c:\Users\xiong\Desktop\Sorting_Visulization_cqz\sortwindow.h", "C++", 38, 0, 0, 11, 49
"Total", "-", 2808, 10, 220, 567, 3605